////////////////////////////////////////////////////////////////////////////////////////////////////
////////////////////////////////////////////////////////////////////////////////////////////////////
//////////////////#/////////////////////////////////////////////////////////////////////////////////
///////////////#//#//#//////////////////////#///////////////////////////////////////////////////////
///////////////#######/////////////////////#////////////////////////////////////////////////////////
///////////////#//#//#////////////////////#/////////////////////////////////////////////////////////
//////////////////#/////////////////////////////////////////////////////////////////////////////////
////////////////////////////////////////////////////////////////////////////////////////////////////
////////////////////////////////////////////////////////////////////////////////////////////////////
////////////////////////////////////////////////////////////////////////////////////////////////////
////////////////////////////////////////////////////////////////////////////////////////////////////
/////////////??/////////////////////////////////////////////////////////////////////////////////////
////////////////////////#///////////////#####///////////////////////////////////////////////////////
///////////////////////##///////////////////////////////////////////////////////////////////////////
//////////////////////####//////////////////////////////////////////////////////////////////////////
####################################################################################################
