////////////////////////////////////////////////////////////////////////////////////////////////////
//////////////////#/////////////////////////////////////////////////////////////////////////////////
/////////////////###////////////////////////////////////////////////////////////////////////////////
//////////////////#/////////////////////////////////////////////////////////////////////////////////
////////////////////////////////////////////////////////////////////////////////////////////////////
////////////////////////////////////////////////////////////////////////////////////////////////////
////////////////////////////////////////////////////////////////////////////////////////////////////
////////////////////////////////////////////////////////////////////////////////////////////////////
////////////////////////////////////////////////////////////////////////////////////////////////////
////////////////////////////////////////////////////////////////////////////////////////////////////
////////////////////////////////////////////////////////////////////////////////////////////////////
////////////////////////////////////////////////////////////////////////////////////////////////////
////////////////////////#///////////////////////////////////////////////////////////////////////////
///////////////////////##///////////////////////////////////////////////////////////////////////////
//////////////////////####//////////////////////////////////////////////////////////////////////////
####################################################################################################
