//////////#/////////////////////////////////////////////////////////////////////////////////////////
////////////////////////////////////////////////////////////////////////////////////////////////////
////////#/#/#///////////////////////////////////////////////////////////////////////////////////////
////////////////////////////////////////////////////////////////////////////////////////////////////
//////////#/////////////////////////////////////////////////////////////////////////////////////////
////////////////////////////////////////////////////////////////////////////////////////////////////
////////////////////////////////////////////////////////////////////////////////////////////////////
////////////////////////////////////////////////////////////////////////////////////////////////////
////////////////////////////////////////////////////////////////////////////////////////////////////
////////////////////////////////////////////////////////////////////////////////////////////////////
////////////////////////////////////////////////////////////////////////////////////////////////////
/////////////?#?////////////////////////////////////////////////////////////////////////////////////
////////////////////////#///////////////#####///////////////////////////////////////////////////////
///////////////////////##///////////////////////////////////////////////////////////////////////////
//////////////////////####//////////////////////////////////////////////////////////////////////////
####################################################################################################
