////////////////////////////////////////////////////////////////////////////////////////////////////
//////////////////###///////////////////////////////////////////////////////////////////////////////
///////////////####/////////////////////////////////////////////////////////////////////////////////
///////////////#//#/////////////////////////#///////////////////////////////////////////////////////
///////////////#######/////////////////////#////////////////////////////////////////////////////////
//////////////////#//#////////////////////#/////////////////////////////////////////////////////////
//////////////////####//////////////////////////////////////////////////////////////////////////////
////////////////###/////////////////////////////////////////////////////////////////////////////////
////////////////////////////////////////////////////////////////////////////////////////////////////
////////////////////////////////////////////////////////////////////////////////////////////////////
////////////////////////////////////////////////////////////////////////////////////////////////////
/////////////?#?////////////////////////////////////////////////////////////////////////////////////
////////////////////////#///////////////#####///////////////////////////////////////////////////////
///////////////////////##///////////////////////////////////////////////////////////////////////////
//////////////////////####//////////////////////////////////////////////////////////////////////////
####################################################################################################
