////////////////////////////////////////////////////////////////////////////////////////////////////
///////////////#//####//////////////////////////////////////////////////////////////////////////////
///////////////#//#/////////////////////////////////////////////////////////////////////////////////
///////////////#//#/////////////////////////#///////////////////////////////////////////////////////
///////////////#######/////////////////////#////////////////////////////////////////////////////////
//////////////////#//#////////////////////#/////////////////////////////////////////////////////////
//////////////////#//#//////////////////////////////////////////////////////////////////////////////
///////////////####//#//////////////////////////////////////////////////////////////////////////////
////////////////////////////////////////////////////////////////////////////////////////////////////
////////////////////////////////////////////////////////////////////////////////////////////////////
////////////////////////////////////////////////////////////////////////////////////////////////////
/////////////?#?////////////////////////////////////////////////////////////////////////////////////
////////////////////////#///////////////#####///////////////////////////////////////////////////////
///////////////////////##///////////////////////////////////////////////////////////////////////////
//////////////////////####//////////////////////////////////////////////////////////////////////////
####################################################################################################
