#/#############################
#///////////////#///////#/////#
###############/#/#####/#/###/#
#///////#///#/#///#//2#///#0#/#
#/#####/#/#/#/#####/#######/#/#
#/#///#///#/////#/#////1#/////#
#/#/###########/#/#/#/###/#####
#/#///////@///////#/#/////#///#
#/#/###/#/#/#######/#######/#/#
#/#/#///#/#/#///////#///////#/#
#/###/#####/#/###########/###/#
#///#/////#/#///////////#///#/#
#/#/###/#/#/###########/###/#/#
#/#///#/#/#//////////6#///#/#3#
#####/###/#########/#####/#/###
#/////#///////#/#///#/////#///#
#/#####/#####/#/#/###/#######/#
#/#///#///#///#/#///#/#///////#
#/#/#/#/#/#/###/###/#/#/#####/#
#/#9#///#/#/#7////#/#///#/#///#
#/###/###/#/###/#/#/#####/#/###
#///#/#///#///#/#/#/#/////#///#
###/###/#####/###/#/#/###/###/#
@///#///#///8/////#///#/////#/#
#/###/###/#############/#####/#
#/#///#///#/////////////#///#/#
#/###/#####/#####/#######/#/#/#
#///#///////#///#///#/////#/#/#
#/#/#########/#/#####/#####/#/#
#5#///////////#//////////4#///#
#############################@#
