#/#/////////###/###/////////////
#/########//#+#/#/##############
#////////#//#/#/#//////////////#
########/####/###/############/#
///////#/////////////////////#/#
########/####/##############/#/#
#///////////#/#//////////////#/#
#/#########/#/#/##############/#
#///////////////////////////////
////////////////////////////////
////////////////////////////////
////////////////////////////////
////////////////////////////////
////////////////////////////////
////////////////////////////////
////////////////////////////////
////////////////////////////////
////////////////////////////////
////////////////////////////////
////////////////////////////////
////////////////////////////////
////////////////////////////////
////////////////////////////////
////////////////////////////////
////////////////////////////////
////////////////////////////////
////////////////////////////////
////////////////////////////////
////////////////////////////////
////////////////////////////////
////////////////////////////////
////////////////////////////////
