#/##############################
#/////#///////#///////////////#/
#####/#/#/#####/#/###########/#/
#/#///#/#///////#///#///////#/#/
#/#/#######/#######/#/#####/#/#/
#/#///////#///#///#/#/////#/#///
#/#######/#####/#/#/#####/#####/
#///////#/#///#/#/#/#///#/////#/
#/###/###/#/#/#/#/#/#/#/###/#/#/
#///#///#/#/#///#/#///#/#///#/#/
###/###/#/#/#####/#####/#/#####/
#/////#/#/#/#///////#///#/#/////
#######/#/#/#######/#/###/#/####
#///////#/#/////#/////#/#///#///
#/#####/#/#####/#######/#/###/#/
#/#///#/#/////#///#/#///#/////#/
#/#/###/#####/###/#/#/#/#######/
#/#/////////#/////#///#///////#/
#/#####################/#####/#/
#/////#///////////#///#///#///#/
#####/#/#######/#/#/#/###/#/###/
#///#///#///////#/#/#/////#/#///
#/#/#####/#######/#/#######/#/##
#/#/////#/#///////#///#///#/#/#/
#/#####/#/#/#########/#/###/#/#/
#/#///#///#/#///////#/#/#///#///
#/#/#/#####/#/#####/#/#/#/#####/
#/#/#///#/#/#/#///#/#/#///////#/
#/#/###/#/#/#/#/###/#/#/#######/
#///#/#/#/////#///////#/#///#///
#/###/#/#################/#/#/##
#/////#///////////////////#/////
