#/#############################
#///////////////#///////#/////#
###############/#/#####/#/###/#
#///////#///#/#///#///#///#/#/#
#/#####/#/#/#/#####/#######/#/#
#/#///#///#/////#/#/////#/////#
#/#/###########/#/#/#/###/#####
#/#///////#///////#/#/////#///#
#/#/###/#/#/#######/#######/#/#
#/#/#///#/#/#///////#///////#/#
#/###/#####/#/###########/###/#
#///#/////#/#///////////#///#/#
#/#/###/#/#/###########/###/#/#
#/#///#/#/#///////////#///#/#/#
#####/###/#########/#####/#/###
#/////#///////#/#///#/////#///#
#/#####/#####/#/#/###/#######/#
#/#///#///#///#/#///#/#///////#
#/#/#/#/#/#/###/###/#/#/#####/#
#/#/#///#/#/#/////#/#///#/#///#
#/###/###/#/###/#/#/#####/#/###
#///#/#///#///#/#/#/#/////#///#
###/###/#####/###/#/#/###/###/#
#///#///#/////////#///#/////#/#
#/###/###/#############/#####/#
#/#///#///#/////////////#///#/#
#/###/#####/#####/#######/#/#/#
#///#///////#///#///#/////#/#/#
#/#/#########/#/#####/#####/#/#
#/#///////////#///////////#///#
#############################/#
