+#+#############
+#++++++++######
+########+######
+++++++##++++++#
######+#######+#
#++++++##++++#+#
#+##########+#+#
#+#++++++++#+#+#
#+##############
################
################
################
################
################
################
################
