#/#############################
#///////////////#///////#/////#
###############/#/#####/#/###/#
#///////#///#/#///#//2#///#0#/#
#/#####/#/#/#/#####/#######/#/#
#/#///#///#/////#/#////1#/////#
#/#/###########/#/#/#/###/#####
#/#///////#///////#/#/////#///#
#/#/###/#/#/#######/#######/#/#
#/#/#///#/#/#///////#///////#/#
#/###/#####/#/###########/###/#
#///#/////#/#///////////#///#/#
#/#/###/#/#/###########/###/#/#
#/#///#/#/#///////////#///#/#3#
#####/###/#########/#####/#/###
#/////#///////#/#///#/////#///#
#/#####/#####/#/#/###/#######/#
#/#///#///#///#/#///#/#///////#
#/#/#/#/#/#/###/###/#/#/#####/#
#/#/#///#/#/#/////#/#///#/#///#
#/###/###/#/###/#/#/#####/#/###
#///#/#///#///#/#/#/#/////#///#
###/###/#####/###/#/#/###/###/#
#///#///#/////////#///#/////#/#
#/###/###/#############/#####/#
#/#///#///#/////////////#///#/#
#/###/#####/#####/#######/#/#/#
#///#///////#///#///#/////#/#/#
#/#/#########/#/#####/#####/#/#
#/#///////////#///////////#///#
#############################@#
