#/##############################
#///#/////#/////////////////#///
###/#/#####/#/#############/#/##
#/#/#/#/////#///#///////#///#///
#/#/#/#/#######/#/#####/#/###/#/
#/#/#///#/////#/#/#/#///#/#///#/
#/#/#####/###/#/#/#/#/###/#####/
#/#/////#/#/#///#///#///#/////#/
#/#####/#/#/#####/#####/#####/#/
#/////#/#/#/////#/#///#/////#/#/
#/###/#/#/#/###/###/#/#/#/###/#/
#/#///#/#/#/#/#///#/#///#/#///#/
#/#####/#/#/#/###/#/#####/#/###/
#/////#///#/#///#/#///#/#/#/#///
#/###/#####/###/#/###/#/#/#/#/##
#///#///////#///#/#///#///#/#///
#########/###/#/#/#/###/###/###/
#///#///#/#///#/#///#/#///#///#/
#/#/#/#/#/#/###/#####/###/###/#/
#/#/#/#///#/#///#///////#/#/#///
#/#/#/#####/#/#########/#/#/###/
#/#///#/////#///////////#/#///#/
#/#####/###############/#/#/#/#/
#/#/////#///////#///////#///#/#/
#/#/#####/#####/#############/#/
#/#/#/////#///#///////////////#/
#/#/#/#####/#/#/###############/
#/#/#///#///#/#///#///#///////#/
#/#/###/#/###/#/###/#/#/#####/#/
#/#/////#/#///#/#///#/#/#/////#/
#/#######/#/#####/###/#/#/#####/
#/////////#/////////#///#///////
