#/#############################
#///////#///////////////#/////#
#######/###/#########/#/###/#/#
#/////#///#/#/////#///#/////#/#
###/#/###/###/###/#/###########
#///#///#///#/#///#///////////#
#/#####/###/#/#/#######/#####/#
#/////#///#///#/#/////#/#/////#
#/###/###/#####/#/###/###/###/#
#///#/#/#/#///#///#/#///#/#///#
#####/#/#/#/#######/###/#/#/###
#///#/#///#/////////#/#///#///#
#/#/#/#/#####/#####/#/#######/#
#/#/#/#///////#/#///#/////#/#/#
#/#/#/#########/#/#####/#/#/#/#
#/#///#/////////#/#/////#///#/#
#/###########/#/#/#/#####/###/#
#/#/////////#/#/#///#///#/#///#
#/#/#######/#/#/#####/#/#/#/###
#/#///#///////#///////#/#/#///#
#/###/###############/###/###/#
#///#/#///////#///////#///#/#/#
###/#/#/#####/#########/###/#/#
#///#///#///#/////////#/#///#/#
#/###/#####/#########/#/###/#/#
#///#///#///#///////#/#///#/#/#
###/###/#/#/#/#####/#/###/#/#/#
#///#/////#/#/#/////#///////#/#
#/###########/#/#############/#
#/////////////#///////////////#
#############################@#
