#/#############################
#/////////////////////#///////#
#####################/#/#####/#
#/////#/#/////////#///#///#/#/#
#/###/#/#/#/#######/#####/#/#/#
#/#/#/#///#/////#///#///#/#/#/#
#/#/#/###/#####/#/###/#/#/#/#/#
#/#/#///#///#///#/#///#///#/#/#
#/#/###/#####/###/#/#/#####/#/#
#/#///#/////#///#/#/#/#/#/////#
#/#/#/#####/#/#/#/###/#/#/#####
#/#/#/////#/#/#/#/////#///#///#
#/#####/#/#/###/#######/###/#/#
#/#/////#/#///////////#/////#/#
#/#/###########/#############/#
#/#/#///#///#///#///////////#/#
#/#/#/#/#/#/#/###/###/#####/#/#
#/#///#///#/////#/#///#/#///#/#
#/###############/#/###/#/###/#
#/#///////#/////#/#///#/////#/#
#/#/#####/#/###/#/###/#####/#/#
#/#/////#/////#/#///#/////#/#/#
#/###/#########/###/#####/#/#/#
#/////#///#///#///#/#///#/#/#/#
#/#####/#/#/#/###/#/###/#/###/#
#///#///#///#/////#/#///#///#/#
###/#/###########/#/#/#/###/#/#
#/#/#///#/////////#///#///#///#
#/#/###/#################/#####
#/////#///////////////////////#
#############################/#
