#/##############################
#/////#/////////////////#///////
#####/#/###############/###/###/
#///#///#/////////////#/////#/#/
#/#/#####/###########/#######/#/
#/#///////#///#/#/////#///////#/
#/#########/#/#/#/#########/#/#/
#/#///#/////#///#///#///#///#/#/
#/#/#/###/#/#######/#/#/#/#/###/
#/#/#///#/#/#/////#/#/#/#/#/#///
#/#/###/###/#/#/###/#/#/#/#/#/##
#/////#/#///#/#///////#///#/#/#/
#/#####/#/###/###############/#/
#///#///#/////////#/////////#///
#/###/#####/#####/#/#######/###/
#/#///#///#/#///#/#/#/#///////#/
#/#/#/#/#/#/#/#/###/#/#/#######/
#/#/#/#/#/#/#/#/////#/#/#/////#/
###/###/#/#/#/#######/#/#/###/#/
#///#///#/#/#/////#///#/#///#///
#/###/###/#######/#/#/#/###/####
#///#///#///////#///#/#/#///#///
#/#/###/#####/#######/#/#/###/#/
#/#///#/////#/////#///#/#///#/#/
###/#/#####/###/###/###/###/###/
#///#/#/////#/#///////#///#/////
#/#/###/#####/#########/#/#####/
#/#/#///#/////#/////#///#/////#/
#/###/###/###/###/#/#/#########/
#///#///#///#/#///#/#/////#///#/
#/#/###/###/#/#/###/#####/#/#/#/
#/#/////////#///#///////#///#///
