#/#############################
#///////#/////#/////#/////////#
#######/###/#/###/#/###/#####/#
#/#///#/////#/////#///#/////#/#
#/#/#/###############/#/###/#/#
#///#///#/////////#///#///#/#/#
#/###/#/###/###/###/#####/#/###
#/#///#/#///#///#///#///#/#///#
#/#/###/#/#####/#/###/#/#####/#
#/#/#///#/////#/#/////#///////#
#/#/#/###/###/###############/#
#/#/#///#/#///#/////////////#/#
###/###/###/###/###/#########/#
#///#/#/////#///#///#/////////#
#/###/###/###/###/###/#########
#/#/////#/#///#/#///#/////////#
#/#/#/###/#/###/###/#########/#
#/#/#/////#///#///#/////////#/#
#/###/#######/#/#/#########/#/#
#///#///#///////#///#/////#/#/#
###/###/#/###########/###/#/#/#
#///#///#/#///#///////#/#///#/#
#/#######/#/###/#######/###/#/#
#/////#///#/#///#///////////#/#
#/###/#/###/#/###########/###/#
#/#///#/////#///#///////#///#/#
###/#/#####/###/#/#####/#####/#
#///#/#///#///#/#///#///#///#/#
#/#####/#/###/#/###/#/###/#/#/#
#///////#/////#/////#/////#///#
#############################@#
