#/##############################
#///////#///////////////////////
#######/#/#####################/
#/////#///#///#///////#///////#/
#/###/#####/#/#/###/###/###/###/
#/#/////////#/#/#/#/////#/#/////
###/###########/#/#######/######
#///#/////////#/#/////#/////////
#/###/#######/#/#/###/###/#####/
#///#/#/#/////#///#///#///#///#/
###/#/#/#/###/#####/###/#####/#/
#///#///#///#///#///#///#///#/#/
#/#/###/###/###/#/###/###/#/#/#/
#/#///#///#///#/#/////#///#///#/
#/#####/#####/#/#######/#####/#/
#///////#/////#/////////#///#/#/
#########/###############/#/#/#/
#///////#/#///#///#/////#/#/#/#/
#/#####/#/#/#/#/#/#/###/#/#/###/
#/#///////#/#///#///#/#///#/////
#/#######/#/#########/##########
#/////#///#/////#///#///#/////#/
#####/#########/#/#/#/#/###/#/#/
#///#/#///////#///#///#///#/#///
#/#/#/#/#####/###########/#/###/
#/#///#///#///#/////////#///#/#/
#/###/#/###/#/###/#####/#####/#/
#/#///#/#///#/////#///#///////#/
#/#/###/#/###/#####/#########/#/
#/#/#///#/#///#///#///////////#/
#/###/###/#####/#/#############/
#///////#///////#///////////////
