#/##############################
#/////#/////////#///////////////
#####/#/#######/#/#############/
#///#/#/#/////#/#/////#///#/#///
#/#/#/#/#/#####/#####/#/#/#/#/##
#/#/#///#/#/////#///#/#/#///#///
#/#/#####/#/#####/#/#/#/#######/
#/#/////#///#/////#///#///////#/
#/#####/#/###/#############/#/#/
#/#/////#/#///#/////#/////#/#/#/
#/#######/#/#####/#/#/###/#/#/#/
#///////#///#/////#/#///#/#/#/#/
#/#####/#####/#####/###/#/#/###/
#/#///#///#///#///#/////#///#///
###/#/#/#/#/###/#/#########/#/##
#///#/#/#///#///#/////////#/#///
#/###/#/#####/#############/###/
#/#///#///#///#///////#/////#/#/
#/#/#####/#/#/#/#####/#/#####/#/
#/#///#///#/#///#/#///#///////#/
#/###/#/###/#####/#/#########/#/
#///#///#/#/#/////#/////////#/#/
###/#####/#/#/#######/###/###/#/
#///#///////#///////#///#/#///#/
#/###/###########/#/###/###/###/
#/#///#///////#///#/#///#///#///
#/#/#######/#/#/###/#/#/#/###/##
#/#///////#/#/#/#///#/#/#/#/#/#/
#/#######/#/#/#/#/###/###/#/#/#/
#/#/////////#///#///#///////#///
#/#############################/
#///////////////////////////////
