#/#############################
#/////#///////////////#///////#
#####/#/#############/#/#####/#
#///#/#/////#///#///#///#///#/#
#/###/###/#/###/#/#/#####/#/#/#
#///#///#/#///#///#/#/////#/#/#
#/#/###/#####/#####/#/#/#####/#
#/#///#/////#/#///#///#/#///#/#
###/#/#####/#/#/#/###/#/#/#/#/#
#///#/////#/#///#///#/#///#/#/#
#/#########/#######/#/#####/#/#
#/////////#/////#///#///#///#/#
#/#######/#####/#/#######/###/#
#/#///////#///#///#/////#///#/#
###/#####/#/#/#####/#/#/###/#/#
#///#///#///#/////#/#/#/////#/#
#/###/#/#########/###/#####/#/#
#///#/#///#/////#/////#///#/#/#
#/#/#/###/#/###/#######/###/#/#
#/#/#///#///#/#///////#///#/#/#
#/#/###/#####/#######/#/#/#/#/#
#/#///#/#///#/////////#/#///#/#
#####/#/#/#/#####/#####/#####/#
#/////#///#/////#/#///#/#/#///#
#/#####/#######/###/#/#/#/#/###
#/////#/#/////#/#///#///#/#///#
#/###/#/#/###/#/#/#######/###/#
#///#/#/#///#/#/////////////#/#
###/#/#####/#/###############/#
#///#///////#/////////////////#
#############################/#
