#/##############################
#/////////////#///////////////#/
#############/#/#############/#/
#///////#/////#/#/////////#///#/
#/#####/#/#####/#####/###/#/###/
#/#///#/#/#///#/////#///#/#/////
#/#/#/#/#/#/#/#####/###/#/#####/
#/#/#/#/#///#///////#///#/////#/
#/#/###/#############/#######/#/
#/#///#///////////#///#/////#/#/
#/#/#/###########/#/###/#####/#/
#/#/#///#/////#///#/#/////////#/
#/#/###/#/#/###/###/###########/
#/#///#///#/////#/////#///////#/
#/#######/#########/#/#/#####/#/
#/#/////#///#/////#/#/#/#///#///
#/#/###/###/###/#/###/#/#/#/####
#/////#/#/#/////#/////#///#/////
#/#####/#/###########/#########/
#/#/////#/////#///////////////#/
###/#####/###/#/#############/#/
#///#/////#/#/#/#///////#/////#/
#/###/#####/#/#/#/#####/#####/#/
#///#/////#///#/#/////#/////#/#/
#/#/#####/###/#/#####/#####/###/
#/#/////#///#/#///#///#///#///#/
#/#####/#/#/#/###/#/###/#/###/#/
#/////#/#/#/#///#/#/#///#///#///
#/#####/#/#/#####/#/#/#####/####
#/#/////#/#///////#/#/#///#///#/
#/#/###############/#/#/#/###/#/
#/#///////////////////#/#///////
