#/#############################
#/#///////////////////////////#
#/#/#########################/#
#///#///////////////////#///#/#
###########/###########/#/#/#/#
#///////////#/////////#/#/#///#
###/#########/#/#######/#/#####
#///#/////////#/#///#///#/#///#
#/###/#########/#/#/#/###/#/#/#
#///#/////#///#/#/#///#///#/#/#
#/#/#####/#/#/#/#/#####/###/#/#
#/#/#/////#/#///#/////#/#///#/#
###/#/#########/#/#####/#/###/#
#///#/////////#/#/#/////#/#/#/#
#/###/#######/###/#/#####/#/#/#
#/#///#/////#///#/#///////#///#
#/#####/###/#/#/#/#########/###
#/#///#/#///#/#/#/#/#/////#/#/#
#/#/#/#/#/#####/#/#/#/#/###/#/#
#/#/#/#/#/////#/////#/#/////#/#
#/#/#/#/#####/#####/#/#######/#
#/#/#///#///#///#///#/#///////#
#/#/#######/###/#####/#/#####/#
#/#///////////#///#///#/////#/#
#/###########/###/#/###/###/#/#
#/////////#///#/#///#///#///#/#
#/#######/#/###/#########/###/#
#/////#///#/#///////////#/#/#/#
#/###/#####/#/#########/#/#/#/#
#///#/////////#///////////#///#
#############################/#
