#/#############################
#///////#/////////#/////#/////#
#######/#/#######/#/#/#/#/###/#
#///#/#/#///#///#/#/#/#///#///#
#/#/#/#/###/###/#/#/#/#########
#/#///#///#/#///#/#/#///#/////#
#/#######/#/#/###/#/###/#/###/#
#///////#///#///#/#///#///#///#
#/#####/#####/#/#/#########/#/#
#/#///#/////#/#/#///////#///#/#
#/#/#/###/#/###/#######/#/###/#
#/#/#/////#///#///////#///#///#
#/#/#########/#####/#/#####/###
#/#/#///////#///////#///#///#/#
#/#/###/###############/#/###/#
#/#///#/////////////#///#/////#
#/###/###/#####/#####/#######/#
#///#///#///#///#///#/#/#///#/#
#/#####/#####/#/#/#/#/#/#/#/#/#
#/#/////#/////#/#/#/////#/#///#
###/#####/#####/#/#######/#####
#///#/////#/////#///#/////#///#
#/#####/#######/###/#/#######/#
#/#/////#/////#///#/#///////#/#
#/#/#####/###/#/###/#######/#/#
#/#///////#///#/#///////#///#/#
#/###/#####/#####/#####/#/###/#
#///#/#///#///////#///#/#///#/#
#/#/###/#/#########/#/#####/#/#
#/#/////#///////////#/////////#
#############################/#
