#/##############################
#/////////////////////#///#/////
#####################/#/#/###/#/
#///////////////////#///#///#/#/
###/###/###################/###/
#///#///#/////////////////#///#/
#/#######/###############/###/#/
#/#///#/////#///#///#/////#///#/
#/#/#/#/#####/#/#/#/#/#/###/###/
#/#/#/////#///#///#/#/#/#///#///
#/#/#######/#######/#/#/#/###/#/
#/#///#/////#/////#///#/#/#///#/
#/#/###/#####/#####/#####/#/###/
#/#/#///#///#///#///#/////#/#///
#/#/#/###/#/###/#/###/#####/#/##
#/#/#/////#///#/#/#/#/#/////#///
#/#/#########/#/#/#/#/###/#####/
#/////#///////#/#///#///#///#/#/
#######/#######/###/###/###/#/#/
#///////#/////////#/#/#/////#///
#/#########/#/#####/#/#######/##
#/#///////#/#/#///#/////////#/#/
#/###/###/#/###/#/###/#######/#/
#///#/#///#/#///#///#/#///////#/
###/#/#/###/#/###/###/#/#######/
#///#/#/////#///#/////#/////////
#/###/#########/###############/
#/#///////////////#///////////#/
#/#######/#####/###/#####/###/#/
#/#/////#/#///#/#///#/#///#///#/
#/#/###/###/#/###/###/#/#######/
#/////#/////#/////////#/////////
