#/##############################
#///#/////#/////////////////////
###/#/###/#/###/###############/
#/#///#///#/#///#/////////////#/
#/#####/#####/#####/#########/#/
#/////#/#/////#/////#///#/////#/
#/###/#/#/#####/#/###/###/#####/
#/#///#/#///#///#///#///#///#/#/
#/#####/###/#/#####/###/###/#/#/
#/#/////#///#/#/#///#///#///#/#/
#/#/#####/###/#/#/###/###/###/#/
#/#///////#/#/#/#///#///#/#///#/
#/#########/#/#/###/#/#/#/###/#/
#/#///////#///#///#/#/#/#///#/#/
#/#/#####/#/###/#/#/#/#/###/#/#/
#///#///#///////#/#/#/#/#///#/#/
#####/#/#########/#/###/#/###/#/
#/////#///#/////#/#/#///#/#///#/
#/#######/#/###/###/#/#/#/###/#/
#///#///#/#/#/#///#/#/#/#///#/#/
#/#/#/#/#/#/#/###/#/#/#/###/#/#/
#/#/#/#/#/#/#///#///#/#/#/#///#/
#/#/#/###/#/#/#######/#/#/###/#/
#/#/#///#///#/#///////#///#///#/
#/#/#/#/#####/#/###/###/###/###/
#/#/#/#///#///#/#///#///#///#/#/
#/#/#####/#/#/#/#/#######/###/#/
#/#/////#///#///#/#///////////#/
#/#####/#/#######/#/#########/#/
#///#///#///#///#///#///#///#/#/
###/#/#######/#/#####/#/#/#/###/
#///#/////////#///////#///#/////
