#/#############################
#///////////#///#///#/////////#
###########/#/#/#/#/###/#####/#
#/////////#///#///#/////#/#///#
#/#######/###############/#/###
#///#/////#///////#///////#/#/#
###/#/#####/#####/#/#####/#/#/#
#///#/#/////#///#///#/////#///#
#/###/#/#####/#/###/#########/#
#/#/////#/////#///#/#/////#///#
#/#######/#########/#/###/#/###
#/#///#///////////#/#/#/#///#/#
#/#/#/###/#######/#/#/#/#####/#
#///#///#///#/////#/#/#///////#
#/#####/###/#/###/#/#/#/#####/#
#/////#/#///#/#/#/#/#///#///#/#
#####/#/#####/#/#/#/#######/#/#
#/////#///#///#///#/////////#/#
#/#######/#/#############/###/#
#/////#///#///#///#/////#/#///#
#####/#/###/#/#/#/#/#/###/#/###
#///#/#/#///#///#/#/#/#///#/#/#
#/###/#/#/#######/#/#/#/###/#/#
#/////#/#/#/////#///#///#///#/#
#/#####/#/#/#####/#####/#/###/#
#/////#/#///#///#/#///#/#///#/#
###/###/###/#/#/###/#/#####/#/#
#/#/#///#///#/#/////#///#///#/#
#/#/#/#######/#########/#/###/#
#///#/////////////////#///////#
#############################@#
