#/##############################
#///////////////#///#///////////
###############/#/#/#/#####/###/
#/////#///#/#///#/#/#/////#/#///
#/###/#/#/#/#/###/#/###/###/#/##
#/#///#/#/#/#/#///#///#/#///#///
#/#/###/#/#/#/###/###/###/#####/
#/#/////#///#/////#/#///#/#///#/
#/#########/#######/###/#/###/#/
#/#///#///#/#/////////#///#///#/
#/#/###/#/#/###/#####/#####/#/#/
#/#///#/#/////#/#///#///////#/#/
#/#/#/#/#####/#/#/###########/#/
#/#/#/#/#///#///#/////////////#/
#/#/#/#/#/#/#####/#########/###/
#/#/#///#/#/#///#///#/////#///#/
#/###/###/#/#/#####/#/###/###/#/
#///#/#///#/#/////#/#/#///#///#/
#/#/###/###/#####/#/#/#/#####/#/
#/#///#/#///#///#///#/#/////#/#/
#####/#/#/###/#/###/#/#####/#/#/
#///#/#/#/////#///#/#/#///#/#/#/
#/#/#/#/#########/###/#/#/#/#/#/
#/#///#///#/////#///#/#/#/#/#/#/
#/###/###/#/###/###/#/###/#/###/
#/#/////#///#/////#/#/////#///#/
#/###########/#####/#####/###/#/
#///////////#///#///#/////#/#///
#/#####/###/#/###/###/#####/####
#/#/////#///#/#///#///#///#/////
#/#/#########/#/###/###/#/#/###/
#/#///////////#/////////#///#///
