#/#############################
#/////#///#/////////#/////////#
#####/#/###/###/###/#/#######/#
#/////#///////#/#/#/#/#/////#/#
#/###########/#/#/#/#/#/###/#/#
#///#/////#///#/#/#/#/#/#/#/#/#
###/#/###/#####/#/#/#/#/#/#/#/#
#/#/#/#/#///#///#/#///#/#///#/#
#/#/#/#/###/#/###/#####/#/###/#
#///#/#///#///#/////////#///#/#
#/###/###/#######/#######/###/#
#/#/////#///////#/#/////#/#///#
#/#####/#/#####/#/#/###/###/###
#///////#///#/#///#///#/////#/#
###########/#/###/###/#######/#
#/#/////////#/#///#/#/////////#
#/#/#/#######/#/###/#########/#
#/#/#///#/////#/#///////////#/#
#/#/###/#/#/###/#/#########/#/#
#/////#/#/#///////#/////#///#/#
#/#####/#/#########/###/#/###/#
#///#///#/#///#/////#///#///#/#
###/#/#####/#/#####/#/#####/#/#
#///#/////#/#/////#/#/////#/#/#
#########/#/#####/#/#######/#/#
#/////#///#///#///#///#///#/#/#
#/###/#/#/###/#/#####/#/#/#/#/#
#/#/////#/#///#/////#///#///#/#
#/#########/#######/#########/#
#/////////////////#///////////#
#############################@#
