#/##############################
#///////#/////#///////////#/////
#######/#/#####/#/#######/#/###/
#///#///#/#/////#///#/////#/#/#/
#/###/###/#/#######/###/###/#/#/
#/#///#/#///#/////#///#/////#///
#/#/###/#/###/###/###/#######/##
#/#/#/////#///#/#/#///#///#///#/
#/#/###/###/###/#/#/###/#/#/###/
#/#///#/#///#///#///#/#/#///#///
#/###/###/###/#/#####/#/#####/#/
#///#/////#///#///////#/#/////#/
###/#######/#########/#/#/#####/
#///////////#///////#/#///#///#/
#/###/#######/#####/#/#####/#/#/
#///#/#///#///#/////#/#/////#/#/
###/#/#/#/#/###/#####/#/###/###/
#///#/#/#/#/#///#/////#/#///#///
#/###/#/#/#/#####/#######/###/##
#///#/#/#/#/#///#///////#/#///#/
#/#/###/#/#/#/#/#######/#/#/###/
#/#/////#/#///#/#///#/////#/////
#/#######/#####/#/#/#/#########/
#/#///#///#/////#/#///#///////#/
###/#/#/###/###/#/#####/#/###/#/
#///#/#/#///#///#/////#/#///#/#/
#/###/#/#/#######/#####/###/###/
#/#/////#/////////#/////#/#/////
#/#/#########/#####/#####/######
#/#/#///#///#///#///#///////////
#/###/#/#/#/#####/#####/#######/
#/////#///#/////////////#///////
