#/#############################
#/#///#///////////////////#///#
#/#/#/###/###############/###/#
#///#///#///////#///////#/////#
#######/#/#####/#/###/#/#####/#
#/////#/#/#/////#/#///#///#/#/#
###/###/###/#######/#####/#/#/#
#///#///#///#///////#///#/#/#/#
#/###/###/#######/###/#/#/#/#/#
#///#/////#/////#/#/#/#///#/#/#
#/#/#######/###/#/#/#/#####/#/#
#/#/////#///#/#///#/#/#/////#/#
#/#/###/#/###/#####/#/#/#/###/#
#/#/#/#/#/#/#///#///////#/#///#
###/#/#/#/#/#/#/#/#########/###
#///#/#/#/#/#/#/#///#///#///#/#
#/###/#/#/#/#/#/###/#/#/#/###/#
#/#///#///#/#/#/////#/#///#///#
#/#/#/#####/#/#######/#######/#
#/#/#///////#///#/////#///////#
#/#/#/#########/#/#####/#####/#
#/#/#/#///#///#/#/#///#/#///#/#
#/#/###/#/#/#/#/#/#/#/#/#/#/#/#
#/#///#/#///#///#///#///#/#/#/#
#/###/#/#################/#/#/#
#///#/////#/////////#/////#/#/#
###/#######/#######/#/#/###/#/#
#///#///////#/////#/#/#///#/#/#
#/###/###########/#/#/###/###/#
#/////////////////#/////#/////#
#############################/#
