#/#############################
#/////#/////#/////#/////////#/#
#####/#/###/#/#/#/###/#####/#/#
#///#/#/#///#/#/#/////#/#///#/#
#/###/#/#####/#/#######/#/###/#
#/#///#///////#/#///#/////#///#
#/#/###########/#/###/#####/#/#
#/#/////////////#/#///#/////#/#
#/###############/#/###/#####/#
#///#/////////#///#/////#/#///#
#/#/#/#/#####/###/#######/#/###
#/#///#/#///#/////////#/#///#/#
#/#######/#/#########/#/#/###/#
#/#///////#///#///#/////#///#/#
#/#/#########/#/#/#########/#/#
#/#/////#///#///#///////////#/#
#/#####/#/###################/#
#///#///#///////#/////////////#
#/###/#####/###/#/###########/#
#///#/#/////#/#///#/////////#/#
#/#/#/#/#####/#####/#######/#/#
#/#/#///#///////////#///////#/#
###/###########/#############/#
#/////////#///#/#///#/////#///#
#/#######/#/#/#/#/#/#/###/#/###
#/////#/#///#///#/#/#/#///#///#
#####/#/#/#####/#/#/#/#/#####/#
#/////#///#///#/#/#///#/////#/#
#/#########/#/###/#######/###/#
#///////////#///////////#/////#
#############################@#
