#/##############################
#/#/////////////#///////#///////
#/###/#########/#/#####/#/#####/
#///#/#/////#///#/#/#///#/////#/
###/#/#/###/#/###/#/#/#######/#/
#/#///#///#/#///#/#///#///////#/
#/#######/#/###/#/#/#####/#####/
#///////#/#///#///#/////#/////#/
#/#/###/#/###/#########/#####/##
#/#/#/////#/#/////////#/////#///
#/#/#######/#########/#####/#/#/
#/#/////#///////////#/#/#///#/#/
#####/#/#/#######/###/#/#/#####/
#///#/#/#/#/////#/#///#/#/////#/
#/#/###/#/#/###/#/#/###/#####/#/
#/#///#/#/#/#///#/#/////////#///
#/###/#/#/#/#####/###/#####/###/
#/#///#/#/#///#/////#/#///#///#/
#/###/#/#/#/#/#/#####/#/#/#####/
#///#///#/#/#/////#///#/#///////
#/#/#####/#/#######/###/########
#/#/#/////#/////#/////#/////////
#/#/#####/###/###/#############/
#/#/////#///#/#///#///////////#/
#/#####/#/#/###/###/###/#######/
#///#///#/#/////#///#///#/////#/
###/#/#########/#/###/###/###/#/
#/#/#/////////#/#/#///#///#///#/
#/#/#########/#/#/#/###/###/#/#/
#/#/#///#/#///#/#/#/#///#///#/#/
#/#/#/#/#/#/#####/#/#/###/#####/
#/////#///#///////#/////#///////
