#/##############################
#///#/////#/////////////#///////
###/#/###/###/#########/#/#####/
#/#///#/#/////#///////#///#///#/
#/#####/#######/#####/#####/###/
#/////////#/////#/#///#/#///////
#/#######/#/#/###/#/###/#/######
#/#///////#/#/#///#/////#/#/////
#/###/#######/#/#######/#/#####/
#///#///#///#/#///////#/#///#///
#/#/###/#/#/#/#/###/#/#/###/#/#/
#/#///#/#/#///#///#/#/#/#///#/#/
#####/#/#/#######/#/#/#/#/###/#/
#/////#/#/////#/#/#/#/#/#/////#/
#/#####/#####/#/#/#/#/#/#######/
#/#///#/////#/#///#/#/#///////#/
#/#/#/#####/#/###/#/#/#######/#/
#/#/#///#///#///#/#/#///#///#/#/
#/#/###/#/#####/###/#/###/#/#/#/
#/#/#///#///////#///#/#///#///#/
#/###/#/#########/###/#/#####/#/
#///#/#///////#///#/#/#/#///#/#/
###/#/#########/#/#/#/#/#/#/#/#/
#///#/#/////////#/#///#/#/#/#/#/
#/###/#/#########/#/###/#/#/###/
#/#/////#///#///#/#/#///#/#///#/
#/#/#####/#/#/#/#/#/#/###/###/#/
#/#///#///#/#/#/#/#/#/#///#/#///
#/###/#/###/#/#/#/###/#/###/####
#///#/#///#///#/#/////#///#/////
#/#/#####/#####/#########/#####/
#/#///////////#/////////////////
