#/#############################
#/////////////////#///////////#
#################/#/#########/#
#///////////#///#/#/#///////#/#
#/###/#####/###/#/#/#/#####/#/#
#/#///#///#/////#///#/#///#/#/#
###/###/#/#####/#####/#/###/#/#
#///#/#/#/////#/#/////#/#///#/#
#/###/#/###/###/#/#####/#/###/#
#/#/////#///#///#///#///#/#/#/#
#/#######/#/#/#####/#/#/#/#/#/#
#///#///#/#/#///#///#/#/#///#/#
#/#/#/#/#/#/###/#/###/#/###/#/#
#/#///#/#/#///#/#/#///#///#/#/#
#/#####/#/#####/#/#/#######/#/#
#///#///#/#///////#/////////#/#
###/#/###/#/###############/#/#
#///#/#///#/#/////////////#/#/#
#####/#/###/#/###########/###/#
#/////#///#/#///#///////#///#/#
#/#####/#/#/###/#####/#/###/#/#
#/#///#/#///#/#/////#/#/#///#/#
#/###/#/#####/#####/#/###/#/#/#
#///#/#/#///////#/////#///#/#/#
###/#/#/###/#####/#####/###/#/#
#///#/////#/#///#///#///#///#/#
#/#######/#/#/#/###/#/#######/#
#/#///#/////#/#///#/#///////#/#
#/#/#/#######/#/###/#######/#/#
#///#/////////#///////////#///#
#############################@#
