#/##############################
#///////#///////////////#///#///
#######/###/###########/#/#/#/#/
#/////#///#///#///////#/#/#///#/
#/#######/###/#/#####/#/#/#####/
#///////#///#/#/#///#/#///#///#/
#/###/#/###/#/#/#/#/#/#####/###/
#/#///#/#/#///#/#/#///#/////#///
#/#/###/#/#####/#/#####/###/#/##
#/#///#/#///////#///#///#/#/#///
#####/#/#######/###/###/#/#/###/
#/////#///////#/#/#///#/#///#///
#/###########/#/#/###/#/#/###/##
#///#///////#///#///#///#///#///
###/#/###########/#########/###/
#///#///#/////#/////////#/////#/
#/#####/#/#/#/#/#######/#/#####/
#/#/////#/#/#/#/#/////#///#///#/
#/#/#####/#/###/#/###/#####/#/#/
#/#/////#/#/////#/#/#///////#/#/
#/#/###/#/#######/#/#########/#/
#/#///#/////#/////#///////#///#/
#/###/#######/#####/#####/#/#/#/
#/#/#/////#///#/////#/#///#/#/#/
#/#/###/###/#####/###/#/###/###/
#/#///#/#///#/////#///#/#/#///#/
#/###/#/#/###/#/###/###/#/###/#/
#///#///#/#///#/#/////#/////#/#/
#/#/###/#/#####/#/###/###/###/#/
#/#///#/#///////#///#///#/#///#/
#/###/#############/###/#/#/###/
#///#/////////////////#///#/////
