#/##############################
#/#///////////////#/////////////
#/#/###/#########/###/#########/
#/#/#///#///////#///#///#///#///
#/###/#####/###/###/###/###/#/##
#/////#/////#/#///#///#/#///#///
#######/#####/#/#####/#/#/#/###/
#///////#/////#/#/////#/#/#///#/
#/#######/###/#/#/#####/#/###/#/
#/#///////#/#/#/#///////#/#///#/
#/###/#####/#/#/#########/#/###/
#///#///#/////#/#/////////#/#///
###/###/#/#####/###/#######/#/##
#///#///#/#///#///#/#///////#///
#/###/#####/#/###/#/#/#####/###/
#/#/#///////#/#///#/#/#///#///#/
#/#/#/#####/#/#/###/#/#/#/#####/
#/#///#///#/#/#/#///#/#/#///////
#/#####/#/###/#/#/#####/########
#/#/////#/////#///#/////#///////
#/#/#########/###/#/#####/######
#/#/#///////#/#/#/#/#///////////
#/#/#/#/#####/#/#/#/###########/
#/#/#/#/#///////#/#///////////#/
#/#/#/#/#/#######/###########/#/
#/#/#/#///#///#/////////#///#/#/
#/#/#####/#/#/#/#######/###/#/#/
#/#/////#/#/#///#/////#///#/#///
#/#####/###/#####/###/###/#/###/
#/#///#/////////#/#///#///////#/
#/#/#/###########/#/###########/
#///#/////////////#/////////////
