#/#############################
#///#/////////////#///////////#
###/#####/#######/#/#########/#
#/#///////#///////#///#/////#/#
#/#########/#########/#/#/###/#
#/////#///#///////////#/#/#///#
#/###/#/#/#############/###/###
#/#/////#///#///////#///#///#/#
#/#########/###/###/#/###/###/#
#///#/#///#/#///#///#///#/////#
###/#/#/#/#/#/###/#####/#####/#
#///#/#/#/////#/#///////////#/#
#/###/#/#######/#######/#####/#
#/#///#/#/////#///////#/#/////#
#/#/#/#/#/###/#/#####/#/#/#####
#/#/#///#/#///#/////#/#/#/////#
#/#####/#/#/#/#####/#/#/#####/#
#/#///#/#/#/#/#///#/#/#/////#/#
#/#/#/###/#/#/#/#/###/#####/#/#
#/#/#///#/#/#/#/#///#/////#/#/#
#/#/###/#/#/#/#/###/#/###/#/#/#
#/#/#///#/#/#/#/#/#/#/#///#/#/#
#/#/#/#/#/#/###/#/#/#/###/#/#/#
#///#/#/#/#///////#/#///#/#/#/#
#####/#/#/#########/#/#/###/#/#
#///#/#/#/////#/////#/#/////#/#
#/#/#/#/#/#####/#/#####/#####/#
#/#///#/#/#/////#/#///#/////#/#
#/#######/#/#######/#/#######/#
#/////////#/////////#/////////#
#############################@#
