#/#############################
#///////#///////////#/////////#
#######/#/#########/###/#####/#
#/////#/#/#///////#///#/////#/#
#/#####/#/#/#####/###/#/###/#/#
#/#/////#/#///#///#///#/#///#/#
#/#/#####/###/#/###/###/#/###/#
#///#///#///#/#/#///#///#/#///#
#/###/#/###/#/###/#######/#/###
#/////#///#/#/#///#///////#///#
#########/#/#/#/#####/#######/#
#///#///#///#/#/#/////#///#///#
#/#/#/#/#####/#/###/#####/#/###
#/#///#///////#/////#///#/#///#
#/###########/#######/#/#/###/#
#///#///////#/////////#/#///#/#
###/#######/###########/#/#/#/#
#///#/////#/////#/////////#/#/#
#/#/#/###/#/###/#/###########/#
#/#/#///#/#/#///#///#///////#/#
#/###/###/#/#######/#/#####/#/#
#/////#///#/////////#///#///#/#
#/#####/#######/#######/#/###/#
#/////#///////#/#/////#/#///#/#
#####/#######/#/#/###/#/###/#/#
#///#/////#/#/#/#/#/#/////#/#/#
###/#####/#/#/###/#/#######/#/#
#///////#/#/#///#/#/////#///#/#
#/#######/#/###/#/#####/#/###/#
#/////////////#/////////#/////#
#############################@#
