#/##############################
#///#/////#///#///////////#/////
###/#/#/#/#/#/###/#######/###/#/
#///#/#/#///#/////#/////#/////#/
#/#####/#############/#/#######/
#/#///#/#/////////////#///////#/
#/#/#/#/#/###/###############/#/
#///#/#/#/#///#/#/////////#///#/
#####/#/#/#/###/#/###/#####/###/
#///#/#/#/#///#///#///#///#/#///
#/#/#/#/#/###/#/###/###/#/#/#/##
#/#/#///#///#/#/#///#///#///#/#/
#/###########/###/###/#######/#/
#/////////#///#///#///#///#///#/
#####/###/#/###/###/#####/#/###/
#///#/#/#///#///#///#/////#/#///
#/#/#/#/#####/#/#/#####/#/#/#/#/
#/#///#///////#/#/#///#/#/#///#/
#/#####/#######/#/#/#/#/#/#####/
#/#/#///////#/#/#///#///#/////#/
#/#/#/#####/#/#/###/#########/#/
#/#///////#/#///#///#///#///#/#/
#/#######/#/#####/###/#/#/#/#/#/
#/#/////#/#///////#///#/#/#///#/
#/#/###/#/#######/#/###/#######/
#///#///#///#///#/#/#///#/////#/
#/###/#####/#/#/###/#/###/###/#/
#/#///#///#/#/#///#/#///#///#///
###/###/###/#/###/#/###/###/####
#///#///////#/#///#///#///#///#/
#/###########/#/#####/#/#####/#/
#/////////////#///////#/////////
