#/#############################
#///////////////#///#///#/////#
###############/#/#/#/#/#####/#
#///////#///////#/#///#///#///#
#/#######/#######/#######/#/#/#
#///////#/#///#///#/////#///#/#
#/#####/#/#/#/#/###/###/#####/#
#/#/////#/#/#///#///#///#/////#
###/#/###/#/#####/#/#####/#####
#///#/#///#/#/////#/#/////#///#
#/###/#/###/#/#####/#/#####/#/#
#/#/#/#/////#/////#/#///////#/#
#/#/#/###########/#/#########/#
#/#///#/////////#/#///#/////#/#
#/###/#/#######/#/###/#/#/###/#
#///#/#///#///#/#/#/#/#/#/////#
###/#/###/###/#/#/#/#/#/#######
#///#///#/#///#///#/#/#///////#
#/#####/#/#/#######/#/#######/#
#/#///////#/////#///#///////#/#
#/#/#########/#/#/#########/#/#
#/#/#///#/////#///#///////#/#/#
#/#/#/#/###/###/###/###/###/#/#
#/#/#/#///#///#/#///#/#/#///#/#
#/###/###/###/###/###/#/#/###/#
#/#///#/#///#///#/////#/#///#/#
#/#/###/###/#/#/#####/#/###/#/#
#///#/////#/#/#///////#/////#/#
#/#####/#/#/#################/#
#///////#/#///////////////////#
#############################@#
