#/##############################
#///////#///////#/////////#/////
#######/###/###/#####/###/#/###/
#/////#///#/#/#/////#/#/#///#/#/
#/###/###/#/#/#####/#/#/#####/#/
#/#/////#///#/////#/#/#/#/////#/
#/#/###########/#/#/#/#/#/###/#/
#/#///////////#/#/#///#///#///#/
#/#####/#####/###/#########/#/#/
#/////#/#///#///#///////#///#/#/
###/###/#/#/###/#####/#/#/###/#/
#/#/#///#/#///#///#///#///#///#/
#/#/#/###/###/###/#/#######/###/
#///#///#/#/////#/#///#///#/#///
#######/#/#######/#/#/###/#/#/##
#///////#/#///#///#/#///#/#/#/#/
#/#######/#/#/#/#####/#/#/#/#/#/
#///#///////#///#///#/#/#/#/#/#/
###/#/#####/#####/#/###/#/#/#/#/
#///#/#///#///////#/////#///#/#/
#/###/#/#/###############/###/#/
#///#/#/#/#/////////////#/#///#/
#/#/#/#/#/###########/#/#/#/###/
#/#/#/#/#/////#/////#/#///#///#/
#/#/###/#####/#/###/#/#######/#/
#/#/////#///#///#///#/////#///#/
#/#######/#/#####/#######/#/###/
#///#/////#/////#/#/////#/#/////
###/#/#######/###/#/#####/#####/
#/#///#/////#/#///#///////#///#/
#/#####/###/#/#/###########/#/#/
#/////////#///#/////////////#///
