#/#############################
#///#/////#///////#/////////#/#
###/#/#/#/###/#/###/###/###/#/#
#///#/#/#///#/#/////#///#/#/#/#
#/#####/###/#####/###/###/#/#/#
#/////#/#/#/////#/#///#///#///#
#####/#/#/#####/###/#####/###/#
#///#///#/////#/////#/////#/#/#
#/#/#####/###########/###/#/#/#
#/#///#///////////#/////#/#/#/#
#/###/#######/###/###/#/#/#/#/#
#/#///#///#///#/#///#/#/#///#/#
#/#/###/#/#/###/###/###/###/#/#
#/#/////#///#/////#/#///#/#/#/#
#/###########/###/#/#/###/#/#/#
#/#///////////#///#///#///#/#/#
#/#/#######/###########/#/#/#/#
#/#/#///#/#/#///////////#/#/#/#
#/#/#/#/#/#/#/#####/#####/#/#/#
#/#///#/#/#/#/////#/////#/#/#/#
#/#####/#/#/#####/#####/###/#/#
#/////#/#///////#/#/#///#///#/#
#/###/#/#######/#/#/#/###/###/#
#/#///#///////#/#///#///////#/#
###/#/#######/#/#/###########/#
#///#/#/////#/#/#/#///////////#
#/###/#/###/#/###/#/###########
#/#///#/#///#/////#///#///////#
#/#####/#/###########/#/#####/#
#///////#///////////////#/////#
#############################/#
