#/##############################
#///////#/#/////////#///#///////
#######/#/#/#/#####/#/#/#####/#/
#/////#/#/#/#/////#/#/#/////#/#/
#/#####/#/#/#####/#/#/#####/###/
#/////#/#/////#///#/#///#/#///#/
#/###/#/#/#####/###/###/#/###/#/
#/#///#/#/#///#/#///////#///#///
#/#/#/#/###/#/#/#########/#/###/
#/#/#/#/////#/#/#///#/////#/#///
#/#/#/#######/#/#/#/#/#####/#/##
#/#/#///////#/#///#/#///#/#/#///
###/#######/#/#/###/###/#/#/###/
#///#/////#/#/#///#///#/#///#///
#/#######/#/#/#######/#/#####/##
#/#///////#/#///#///#/#/#/////#/
#/#/#####/#/###/#/#/#/#/#/#####/
#/#/#/////#///#///#///#/#///////
#/#/#########/#########/#######/
#/#/////#///#/#///#///////#///#/
#/#/###/#/#/#/#/#/#/#/###/#/###/
#/#/#///#/#///#/#///#///#/#///#/
#/###/#/#/#####/#######/#/###/#/
#/#///#/#/////#///#///#/#///#/#/
#/#/#########/###/#/#/#/###/#/#/
#/#/////////#///#/#/#///#///#/#/
#/#####/#####/###/#/#######/#/#/
#/#///#///////#///#///#///#///#/
#/#/#/#######/#/#####/#/#/###/#/
#/#/#///////#/#///#///#/#/#///#/
#/#/#######/#####/#/###/#/#####/
#/////////#///////#/////#///////
