#/##############################
#/////#///////////#/////#///////
#####/###/#######/#/###/###/###/
#///#///#/#/////#///#/#///#///#/
#/#####/#/#####/#####/###/#####/
#///#///#/#///#///////#///#/////
#/#/#/###/#/#/###/###/#/###/###/
#/#/#/////#/#///#/#/#/#/////#/#/
###/#######/###/#/#/#/#######/#/
#///////////#/#///#///#///#///#/
#/###########/#####/###/#/###/#/
#/#///#/////////#/#/////#///#/#/
#/#/###/#/#####/#/#########/#/#/
#/#/#///#/#///#/////#/////#///#/
#/#/#/###/#/#/#####/#/#####/###/
#/#///#///#/#///#///#/#/////#///
#/#####/###/###/#/###/#/#####/##
#/#/////#///#///#/////#///#///#/
#/#/#####/###########/#/###/###/
#/#/////#/#/////////#/#/#///#///
#/#####/#/#/#######/#/#/#/###/#/
#///#///#/////#///#/#/#/#///#/#/
#/#/#/#########/#/#/#/#/###/#/#/
#/#/#/#/////////#/#///#///#///#/
###/#/#/#######/#/#/#####/#####/
#///#/#/#/#///#/#/#/#/////////#/
#/###/#/#/#/#/###/###/#########/
#/#///#///#/#///#/#///#/#/////#/
#/#/#####/#/###/#/#/###/#/###/#/
#/#///////#/#///#///////#/#/#///
#/#########/#/###########/#/####
#///////////#///////////////////
