#/#############################
#///#/////#///////////////////#
###/#/###/#############/#######
#/#///#/#/////#///#///#///////#
#/#####/#####/#/#/#/#/###/###/#
#/////////#/#///#///#///#/#///#
#/#######/#/###########/#/#/###
#/#/////#/#///#/#///////#/#///#
#/#/#####/#/#/#/#/#########/#/#
#/#/////////#///#/////////#/#/#
#/#/###########/#########/###/#
#/#/#/////#///#/////////#/#///#
#/###/###/#/#/#########/#/#/#/#
#///////#/#/#/////#/////#/#/#/#
#########/#/#####/#/#####/#/#/#
#///#/////#/////#/#/////#/#/#/#
#/#/#/#####/###/#/#####/#/#/###
#/#///#/#///#///#/#///#/#/#///#
#/#####/#/###/###/#/#/#/#/###/#
#/#///#///#///#///#/#///#///#/#
#/#/#/#/###/###/###/#######/#/#
#/#/#///#/#/#/////#///////#/#/#
#/#/#####/#/#/###########/#/#/#
#/#/////#/#/#/#/////////#/#///#
#/#####/#/#/#/#/#######/#/###/#
#/#/#/////#/#/#/#/////#///#///#
#/#/#/#####/###/#/###/#/###/###
#/#///#///#/////#/#///#/#///#/#
#/#####/#/#######/#/#####/###/#
#///////#/////////#///////////#
#############################@#
