#/##############################
#/////#///#/////////#///////////
#####/#/#/#/#/#####/#/#########/
#/#///#/#///#///#/#///#/////#///
#/#/###########/#/#####/#####/##
#///#///////////#///#///#/////#/
#/#####/#########/###/#/#/#####/
#/////#/#///////#/////#/#/#/////
#####/#/#/#####/###/###/#/#/###/
#///#///#/////#///#/#///#///#/#/
#/#/#####/###/###/###/#/#####/#/
#/#/////#///#/#/#/////#///////#/
#/#/###/#/###/#/#############/#/
#/#/#/#/#/#///#/////////////#/#/
###/#/#/#/#/#####/###/#####/#/#/
#///#///#/#/#/////#/#/#///#/#/#/
#/###/###/#/#/#/###/#/#/#/###/#/
#/#/#///#/#/#/#///#///#/#/////#/
#/#/###/#/#/#####/#####/#######/
#/#///#/#/#/////#/////#/////#///
#/#/###/#/#####/###/#/#####/#/##
#/#/////#/////#///#/#///////#///
#/###########/###/#/###########/
#///#/////#///#///#/#/////////#/
###/#/###/#/###/###/###/###/###/
#///#///#/#/#/#///#/////#///#///
#/#/###/#/#/#/###/#######/###/##
#/#///#/#///#///#/#/////#/#/#/#/
#/#####/#####/#/#/#/###/#/#/#/#/
#/#///#/#///#/#/#/#///#/////#/#/
#/#/#/#/#/#/#/#/#/###########/#/
#///#/////#///#/#///////////////
