#/#############################
#///#///#///////#/////#///////#
###/#/###/#/#####/#/#/#/#####/#
#///#///#/#///////#/#/#/#/#///#
#/#####/#/#####/###/#/#/#/#/###
#/#///#/#/#///#/#///#///#/#///#
#/#/#/#/#/#/#/###/#######/###/#
#///#/#///#/#/////#/////////#/#
#####/#####/#/#########/###/#/#
#///#/////#/#/#///////#/#///#/#
#/#/#####/#/###/#####/#/#####/#
#/#///#///#/#///#///#/#///#///#
#/###/#/###/#/###/#/#/#/#/#/###
#/#///#///#/////#/#///#/#/#///#
#/#######/#######/#######/###/#
#/#/////#///////#/#/////////#/#
#/#/#/#/#######/#/#/#######/#/#
#///#/#///////#///#/#/////#/#/#
#/###/#######/#####/###/###/#/#
#/#///#/////#///#/////#/////#/#
###/#####/#/###/#####/#/#####/#
#///#/////#///#/#/////#/////#/#
#/###/#/#######/#/###/#######/#
#/#///#/////////#/#///#///////#
#/#/#########/###/#####/#######
#/#/////#///#/////#///#/////#/#
#/#######/#/#####/#/#/#####/#/#
#///#///#/#///#///#/#/#///#///#
#/#/#/#/#/###/#####/#/#/#/###/#
#/#///#/////#///////#///#/////#
#############################@#
