#/##############################
#///////////#///////////////#///
###########/#/#############/#/##
#///////#/#///#///////////#/#///
#/#/###/#/#########/#####/#/###/
#/#///#/////#/////#/#/#///#///#/
#/###/#####/#/###/#/#/#/#####/#/
#///#/#///#/#/#/////#/#/////#/#/
#####/#/#/#/#/#######/#####/#/#/
#/////#/#/#/#///#/////////#/#/#/
#/#####/###/###/###/#/#####/#/#/
#///#/////#/////#///#/#///#/#///
#/#/#/###/#######/#/###/#/#/###/
#/#/#/#///#///////#/#///#///#/#/
#/#/###/#/###/###/###/#######/#/
#/#///#/#/////#/#/#///#///////#/
#####/#/#######/#/#/###/#####/#/
#///#/#///////#///#/////#///#/#/
#/#/#/#/#####/#/#########/###/#/
#/#///#/#///#/#/////#/////////#/
#/#######/#/#/#####/#/#########/
#/#/////#/#///#///#/#/#/////#///
#/#/###/#/#####/###/#/###/###/##
#/#/#///#/#///#/////#/////#///#/
#/#/#/###/#/###/#########/#/###/
#/#/#/////#/////#///#/////#/#///
#/#/#############/#/#/#####/###/
#/#///////////////#///#/////#///
#/#########/#########/#/#####/#/
#/#///#///#/#///////#/#///#///#/
#/#/#/#/#/###/#####/#####/###/#/
#///#///#/////////#/////////////
