#/#############################
#/#/////////////////#/////////#
#/#/###############/#/#######/#
#/#///#/////////#///#///#///#/#
#/###/#/#######/#/#####/#/#/#/#
#/////#///#///#/#/////#/#/#/#/#
#########/#/###/#####/#/#/###/#
#/////////#///#/#///#///#///#/#
#/###########/#/###/#####/#/#/#
#///////////#/#/////////#/#///#
#/#########/#/#########/#/#####
#///#///////#/////#/////#/#///#
###/#/#######/###/#/#####/###/#
#/#/#/#///#/#///#/#/#///#///#/#
#/#/#/#/#/#/#/#/###/#/#/###/#/#
#///#/#/#///#/#/////#/#///#/#/#
#/###/#/#####/#######/###/#/#/#
#///#/#/////#/#/////#/#/#/#///#
#####/#####/#/###/#/#/#/#/###/#
#///#/////#/#///#/#/#/#/////#/#
#/#/#####/#/###/#/#/#/#/#####/#
#/#///////#/#/////#///#///#///#
#/#########/#/###########/#/###
#/#///#/////#///#///#///#/#///#
#/#/#/#/###/###/#/#/#/#/#####/#
#/#/#/#/#/////#/#/#/#/#/////#/#
#/#/###/#/#####/#/#/#/#####/#/#
#/#/////#///////#/#/#///#///#/#
#/###############/#/###/#/###/#
#/////////////////#/////#/////#
#############################@#
