#/##############################
#///////#/////////#///#/////////
#######/###/#####/#/#/#/#######/
#/////#/#///#///#/#/#///#/////#/
#/###/#/#/###/###/#/#####/###/#/
#/#///#///#/////#///#///////#/#/
#/###/#########/###########/#/#/
#///#/#///////#///////////#/#/#/
#/#/###/###/#/###/#######/#/#/#/
#/#/////#///#/#///#/#///#///#/#/
#/#######/###/#/###/#/#/#####/#/
#/#///////#/#/#///#///#///#///#/
###/#######/#/#/#/#####/#/#/###/
#///#///#/////#/#/#/////#/#///#/
#/###/###/#######/#/#########/#/
#///#///#///////#/#/////#///#/#/
###/###/#######/#/###/#/#/#/#/#/
#///#///////#///#///#/#/#/#///#/
#/###/#####/#/#####/###/#/#####/
#///#/#/////#/////#/#///#///#///
###/#/#####/#####/#/#/#/###/#/##
#///#/////#///#/////#/#/#///#/#/
#/#####/#/#####/#####/#/#/###/#/
#/////#/#///#///#///#/#/#/#///#/
#/###/#/###/#/###/#/#/###/#/###/
#///#/#///#///#///#/#/////#/#///
#/###/###/#####/###/#####/#/###/
#/#///#/////#///#/#/////#/#///#/
###/###/#####/###/#####/#/###/#/
#///#///#/////#///////#/#/#///#/
#/#######/#####/#####/#/###/###/
#///////////////#/////#/////////
