#/#############################
#///#/////////#///////////#///#
###/#/#######/###/#######/#/#/#
#/#///#///#///#///#/#/////#/#/#
#/#####/#/#/###/###/#/#####/#/#
#///#///#/#/#///#///#/#/////#/#
###/#/#/###/###/#/###/#/#####/#
#///#/#///#/////#/#///#///#/#/#
#/###/###/#######/#/#####/#/#/#
#///#///#///#/////#///////#/#/#
#/#/###/###/#/#/###########/#/#
#/#///#/#/#///#/////////////#/#
#/###/#/#/#########/#####/#/#/#
#///#///////#/////#/#/////#/#/#
#############/###/###/#####/#/#
#/////#///////#/#/////#///#/#/#
#/###/#/#######/#######/#/#/#/#
#/#/#///#///////#/////#/#/#/#/#
#/#/#########/#/#/###/#/#/#/#/#
#/#///////////#///#/#/#/#///#/#
#/#/#/#############/#/#/#####/#
#/#/#/#/////////#/////#/////#/#
#/###/###/#/#####/#########/#/#
#///#///#/#///////#///////#/#/#
#/#/###/###########/#/#####/#/#
#/#///#/#///////#///#///////#/#
#/###/#/#/#####/#/#########/#/#
#///#/#///#///#///////#///#/#/#
###/#/#####/#/#########/#/###/#
#///#///////#///////////#/////#
#############################@#
