#/#############################
#/////////#/////#/////////////#
#########/###/#/###/###/#####/#
#///#/////#///#///#///#/////#/#
#/#/#/#####/#####/#/#######/#/#
#/#/#/#/////#/#///#/#///#///#/#
#/###/#/#####/#/#####/#/#/###/#
#/////#///#/#///#/////#/#/#///#
#/#######/#/#/#####/###/#/#/###
#///////#/#/#///////#///#/#///#
#######/#/#/#########/###/###/#
#/////#///#/////#/#///#///#/#/#
#/###/#####/###/#/#/#####/#/#/#
#///#///////#/#///#/////#/#///#
###/#########/###/#####/#/#/###
#///#///////////#/#/#///#/#///#
#/###/#####/#####/#/#/###/###/#
#///#/#///#/#/////#/#/////#///#
#/#/#/###/#/#/#####/#######/###
#/#/#///#/#/#/////////#/#///#/#
###/###/#/#/#########/#/#/###/#
#///#///#///////////#/#/#/////#
#/###/#####/#######/#/#/#####/#
#/#///#///#/#///#/#/#///#///#/#
#/#/#/#/#/#/#/#/#/#/###/#/#/#/#
#/#/#/#/#/#/#/#/#/////#/#/#///#
#/#/###/#/###/#/#######/#/#####
#/#/////#/////#/////////#/////#
#/###########################/#
#/////////////////////////////#
#############################/#
