#/##############################
#///#/////#/////////////#///////
###/#/###/###/#########/#/###/##
#/#///#/#/////#///#/#///#///#///
#/#####/#######/#/#/#/#########/
#/////#/////////#///#/////#///#/
#/###/#/###########/#####/#/#/#/
#/#/#/#///#///#/#///#///#/#/#///
#/#/#/#/#/#/#/#/#/#####/#/#/####
#/#///#/#///#/#/#/////#/#/#/////
#/#/###/#####/#/#####/#/#/#/###/
#/#/#///#///#/#/////#///#/#/#///
#/#/#####/#/#/#/###/#/###/###/#/
#/#/////#/#///#/#/#/#/#///#///#/
#/#####/#/#####/#/#/#/#/###/###/
#/#///#/#/#/////#/#/#/#/#///#///
#/###/#/#/###/###/#/#/#/###/#/##
#///#///#/#///#/#///#/#/////#///
###/#/###/#/###/#/###/#########/
#///#/////#///#/////#/////////#/
#/###########/#/#############/#/
#/////#///////#/#///#///////#/#/
#####/#####/###/#/#/#/###/###/#/
#///#/////#/#///#/#///#///#///#/
#/#/#####/#/#####/#####/###/###/
#/#///////#/#/////////#/////#///
#/#########/#/#######/#######/##
#///#/////#///#/////#///#///#///
###/#/#/###/###/###/#####/#/###/
#///#/#/////#///#/#///////#/////
#/###########/###/##############
#///////////////////////////////
