#/#############################
#/#/////////#///////////#/////#
#/#####/###/#####/#####/#/#/#/#
#/////#///#/////#///#///#/#/#/#
#####/###/#####/#####/###/#/#/#
#///#///#///#///#///#/////#/#/#
#/#/###/###/#/###/#/#######/#/#
#/#///#/////#/////#/////////#/#
#/###########################/#
#/#///////#///#/////////////#/#
#/#/###/#/#/#/###/#########/#/#
#///#///#///#/////#/#/////#/#/#
#/###/#############/#/###/#/#/#
#/#///#/////#/////#///#/#/#/#/#
#/#/###/###/###/#/#/###/#/#/#/#
#/#/#///#/#///#/#/#///#/#///#/#
#/#/###/#/###/#/#/###/#/#####/#
#/#///#/#/#///#/#///#/////#///#
#####/#/#/#/###/###/#####/#/###
#/////#/#///////#/////#/#/#///#
#/#####/#############/#/#/###/#
#///#///#///////////#///#/#///#
#/#/#/###/#####/###/#####/#/###
#/#/#/////#///#///#///////#/#/#
#/#/#/#####/#/###/#########/#/#
#/#/#/#/////#/#///#/////////#/#
#/#/###/#####/#/###/#########/#
#/#/////#/////#/#///#///#/////#
#/#######/#######/###/#/#/###/#
#///////#/////////////#///#///#
#############################/#
