#/##############################
#///#///////////////#///#///#///
###/###/###########/#/#/#/#/###/
#/#/////#///////#///#/#///#///#/
#/#######/#####/#/###/#######/#/
#/////////#///#/#/////#///#///#/
###/#######/###/#######/#/#/###/
#///#/////#///#/#///////#/#/////
#/###/#/###/#/#/#/#######/#####/
#///#/#/////#/#///#/////#/////#/
###/#/#######/#####/#/###/#####/
#///#/#/////////////#/#///#/////
#/#####/#############/#/###/####
#/#///#/#/#///////////#///#/////
#/#/#/#/#/#/#############/#####/
#/#/#///#///#/////#///////////#/
#/#/#####/#####/#/#/###########/
#/#/#/#///////#/#/#/#///#/////#/
#/#/#/#/#####/#/#/#/#/#/#/###/#/
#/#/#///#///#///#/#/#/#///#/#///
#/#/#####/#/#####/#/#/#####/####
#/#///#///#/#/////#/#///////#///
#/###/#/###/#/#####/#######/###/
#/#///#/#///#/////#///////#/////
#/#/###/#/#######/#######/#####/
#/#/////#///#///////#///#/#///#/
#/#########/#########/#/#/#/#/#/
#/#///////#/#///#/////#/#///#/#/
#/#/#####/#/#/#/#/#####/#/#####/
#///#/////#///#///#///#///#///#/
#/###/#############/#/#####/#/#/
#///#///////////////#///////#///
