#/##############################
#/////////////#/////////#/#/////
#############/#/#######/#/#/#/#/
#/#///#/////#/#/#/////#/#///#/#/
#/#/#/#/###/#/#/#/#####/#####/#/
#/#/#///#///#///#/////#/////#/#/
#/#/#####/#/#########/#####/#/#/
#///#/#///#///////////////#///#/
#/###/#/#################/#####/
#/////#/#/////////#///#///#///#/
#######/#/#######/#/###/###/###/
#///#///#///////#///#///#///#///
#/#/#/###/#####/###/#/###/#/#/##
#/#///#/#/#///#/#/#/#/#///#/#///
#/#####/#/###/#/#/#/#/#/###/###/
#/#/#///#/////#/#///#///#///#///
#/#/#/#/#####/#/###/###/#####/##
#/#///#///#/#/#///#///#/#/////#/
#/#####/#/#/#/###/#####/#/#####/
#/#/////#///#///#/////#/#///////
#/#/###/#######/#####/#/#######/
#/#/#///#/////#/#///#///////#///
#/#/#/###/#/###/#/#/#######/#/##
#/#/#///#/#/////#/#///#///#/#///
#/#/#####/#######/###/#/###/###/
#/#///#///#/#///////#/#///////#/
#/###/#/###/#/#######/#/#######/
#///#/#/////#/#///////#/#/////#/
#/#/#/#/#####/#/#######/#/###/#/
#/#/#///#/////#/#///////#///#/#/
#/#/#####/#####/###########/#/#/
#/#///////////#/////////////#///
