#/#############################
#///#/////////////////////////#
###/#/#######################/#
#/#/#/#/////////#///#///#/////#
#/#/#/###/#####/###/#/#/#/#####
#/#///#///#/////////#/#///#///#
#/#####/###/#####/###/#####/#/#
#///////#/#/#///#/#///#/////#/#
#/#######/#/#/#/###/###/#####/#
#/#/#/////#/#/#/////#///#///#/#
#/#/#/###/#/#/#######/#/#/#/#/#
#/#/#///#/#/#/////#///#/#/#/#/#
#/#/#/###/#/#####/#/###/#/###/#
#/#///#///#///#///#/#///#/#///#
#/#####/#/###/#/#####/###/#/###
#///#///#///#/#/////#/#///#/#/#
###/#/#/#####/#####/#/###/#/#/#
#///#/#/#/////////#/#/#///#/#/#
#/###/###/#########/#/#/#/#/#/#
#/#/////#/#/#///#///#/#/#/#/#/#
#/#####/#/#/#/#/#/###/#/#/#/#/#
#/#///#/#/#/#/#///#///#/#/#/#/#
#/#/#/#/#/#/#/#######/#/###/#/#
#/#/#///#///#///////#/#///#/#/#
#/#/#####/#########/#/###/#/#/#
#/#/////#/#///////#/#///#/#///#
#/#####/#/#/###/###/###/#/###/#
#/#///#///#/#///#///#///#/#///#
#/#/#/#####/#/###/###/###/#/###
#///#///////#/////////#///////#
#############################/#
