#/##############################
#///////#///////#///////////////
#######/#/#####/#/#############/
#/////#/#/////#///#/////////#///
#/#/###/#####/#####/#######/#/##
#/#/#///#/////#/#///#///#///#/#/
#/###/###/#####/#/#/#/#/#####/#/
#///#/////#/////#/#///#/////#///
#/#/###########/#/#########/###/
#/#///#/////////#/#///////#/////
#/#/#/#/#/#######/#/############
#/#/#/#/#///////#/#/////////////
#/#/###/#######/#/#####/###/###/
#/#/////////#///#/////#/#///#/#/
#/###########/#/#####/###/###/#/
#/////#///////#/////#///#///#/#/
#####/#/#/#########/###/###/#/#/
#/////#/#/#///////#/#///#///#/#/
#/#####/###/#####/###/###/###/#/
#/#///#///#/////#/////#///#///#/
#/#/#/###/#####/#########/#/#/#/
#/#/#/////////#/#///////#/#/#/#/
###/#########/#/###/###/#/#/#/#/
#///#///////#/#///#///#///#/#/#/
#/###/#/#####/###/###/#####/#/#/
#/#///#/#///////#///#/#/#///#/#/
#/#/#/###/#########/#/#/#/#/###/
#/#/#///#/#/#/////#/#/#/#/#/////
#/###/#/#/#/#/#/###/#/#/#/######
#///#/#/////#/#/#///#/#/#///////
#/#/#########/#/#/###/#/#######/
#/#///////////#///////#/////////
