#/#############################
#///#/////////#///////////////#
###/#/#/#####/#/#############/#
#///#/#///#/////#///////////#/#
#/#######/#########/###/#####/#
#///////#///#/////#///#/#///#/#
#######/###/###/#/###/###/#/#/#
#/////#///#///#/#/#///#///#///#
#/#/#####/###/#/#/#/#/#/#######
#/#/////#/////#/#///#/#///////#
#/#####/#######/#####/#######/#
#/////#///#/////#/////#/////#/#
#######/#/###/###/#####/#####/#
#/////#/#///#///#///////#///#/#
#/###/#/###/###/###/#####/#/#/#
#/#///#///#/////#///#/////#///#
#/#/###/#/###/#####/#/#########
#/#///#/#/#///#///#/#/#///#///#
#/###/#/#/#####/#/###/#/#/###/#
#///#/#/#///////#///#///#///#/#
#/#/#/#######/#####/#######/#/#
#/#/#///////#/#///////////#///#
###/#######/###/#######/#####/#
#///#///////////#///#///#///#/#
#/#####/#######/#/#/#####/#/#/#
#/////#/#///#/#/#/#///#///#///#
#####/###/#/#/#/#/###/#/#######
#/////#///#/#///#///#/#///////#
#/#####/###/#######/#/#######/#
#/////////#/////////#/////////#
#############################@#
