#/##############################
#///////////////#/////#///////#/
###############/#/###/#/#####/#/
#///////#/#/////#///#/#///#/#/#/
#/#####/#/#/#######/#/###/#/#/#/
#///#/#/#/#///////#/#/////#///#/
###/#/#/#/#######/#/#######/###/
#///#/#/////////#/#/#/////#///#/
#/###/#########/#/#/#/###/###/#/
#///#///#/////#/#/#/#/#/////#/#/
###/#/#/#/#/###/#/#/#/###/###/#/
#///#/#/#/#///#/#/#/#///#/#///#/
#/###/#/#/###/#/#/#/###/#/#/###/
#/#///#/#/#///#/#/#///#/#/#/////
#/#/#/###/#/###/#/###/#/#######/
#/#/#/#///#/////#/////#///////#/
#/#/#/#/###############/#####/#/
#/#/#/#/////#///#///#///#///#///
#/#/#/#####/#/#/#/#/#/###/#/####
#/#/#/////#///#///#/#///#/#/////
#/#/#####/#########/###/#/#####/
#/#/#/////////////#///#///#/#///
#/#/#################/#####/#/##
#/#///////#/////////#/////#///#/
#/###/###/#/#######/#/#####/###/
#///#/#///#/#/////#///#///#/////
#/#/#/#/###/#/###/###/#/#/#####/
#/#/#/#/////#/#/#///#/#/#/////#/
#/#/#####/###/#/###/#/#/#####/#/
#/#/////#///#/#///#/#/#///#///#/
#/#####/#####/#/#/#/#####/#/###/
#/////#/////////#/#///////#/////
