#/##############################
#/#///////////////////#/////////
#/###/###############/#/#######/
#/////#///////////#///#/////#/#/
#######/#########/#/###/###/#/#/
#/////#///#/////#/#///#/#///#/#/
#/#/###/#/###/###/###/###/###/#/
#/#///#/#///#/#///#/#///#/#///#/
#/###/#/###/#/#/###/###/#/#/###/
#///#/////#/#/#/#///#/#///#///#/
###/#######/#/#/#/#/#/#####/#/#/
#/////#/////#/#///#/#/////#/#/#/
#/#####/#####/#####/###/#/###/#/
#/#///#/#///////#/#///#/#/////#/
#/#/#/#/#/#####/#/###/#/#####/#/
#/#/#///#/////#/////#///#/#///#/
#/#/#####/###/#####/#####/#/###/
#/#/////#/#///#///#///#/////#///
#/#####/#/#/#####/#/###/#####/##
#///#///#/#/////#///#///#///#///
###/#/###/#####/#####/###/#/###/
#///#///#///#///#/////#///#///#/
#/#####/###/#/###/#####/###/###/
#/////#/#/#/#///////#///#///#///
#######/#/#/#########/###/#/#/##
#/////#/#/#/#///#///#/#///#/#/#/
#/###/#/#/#/#/#/#/#/#/#/###/#/#/
#/#/#///#/////#/#/#///#/#///#///
#/#/#####/#######/#####/#/#####/
#/#///////#///#///#/////#/////#/
#/#########/#/#/###/###########/
#///////////#/////#/////////////
