#/#############################
#/#///////////////////////////#
#/#/#########################/#
#///#///#/////////#///#/////#/#
#####/#/###/#####/#/#/#/#/#/#/#
#///#/#/////#///#/#/#/#/#/#/#/#
#/#/#/#########/#/#/#/#/#/###/#
#/#/#/////#///#///#/#///#/////#
#/#/#####/#/#/#####/###########
#/#/#///#///#/////#/////////#/#
#/#/#/#/#########/#########/#/#
#/#///#///#///////////////#///#
#/#######/#/#############/###/#
#/#/////#/#/#/////#/////#/#/#/#
#/#/###/#/#/#/###/#/#/###/#/#/#
#///#///#///#///#///#/#///#/#/#
#/###/#########/###/###/###/#/#
#///#/#/////////#/#/#///#///#/#
#/###/#/#########/#/#/###/#/#/#
#/#///#/#/////////#/#/#///#/#/#
#/#/###/###/#/###/#/#/###/#/#/#
#/#/#/////#/#/#///#/#/////#/#/#
#/#/#/###/###/#####/#######/#/#
#/#/#/#/#///#///////#///#///#/#
#/#/#/#/###/#####/###/#/#/###/#
#/#/#/////#/////#/////#/#/#///#
#/#/#####/#####/#########/#/###
#/#///#///#///#///////////#/#/#
#/###/#####/#/#############/#/#
#///#///////#/////////////////#
#############################/#
