#/##############################
#/////////////////#///#///////#/
#################/#/#/#/#####/#/
#///////////#///#/#/#/#/#///#///
#/#########/#/#/#/#/#/#/#/#####/
#/#///#/////#/#/#///#///#/////#/
#/#/###/#####/###########/###/#/
#/#/#///#///////////#///#/#/#/#/
#/#/#/###########/###/#/#/#/#/#/
#/#///////#/////#///#/#/#///#///
#/#######/#/###/###/#/#/###/####
#///#///#/#///#///#///#///#/#///
###/#/###/###/###/#/###/###/#/##
#///#///#/////#/#/#/#///#///#///
#/###/#/#######/#/###/#/#/#####/
#/#///#///#/////#///#/#/#///////
#/#/###/#/#####/###/#/#/#######/
#/#/#///#///#/////#///#/////#///
#/###/#####/#/###/#####/#####/##
#///#///#///#///#/////#/#///#///
###/#/#/#/#####/#######/#/#/###/
#///#/#/#/////#/#/////#/#/#/////
#/#####/#####/#/#/###/#/#/######
#/////#/#///#///#///#///#///////
#/###/#/#/#/#######/###########/
#/#///#///#/////////#/////#///#/
#/#/###/#####/#####/#/###/###/#/
#/#///#/#///#/#///#///#///////#/
#/###/#/#/#/###/#/###########/#/
#///#/#/#/#///#/#///////#/////#/
###/#/###/###/#/#######/#######/
#///#///////#/////////#/////////
