#/##############################
#///#///////#/////#///////////#/
###/#####/#/#####/#/#/#######/#/
#/#///////#/////#///#///#/////#/
#/#############/#####/#/###/###/
#///////////#///#///#/#///#/////
#/#########/#/###/#/###/#/#####/
#/#/////#///#/#///#///#/#///#/#/
#/#/###/#/###/#/#####/#/###/#/#/
#/#/#/#/#/#/#/#/#/#///#/#///#/#/
#/#/#/#/#/#/#/#/#/#/#####/###/#/
#/#/#/#/#///#///#/#/#/////#///#/
#/#/#/#/###/#####/#/#/#/#####/#/
#/#/#/////#///////#/#/#/#///#///
#/#/#####/#######/#/#/#/#/#/#/##
#/#/////#///#///#/#/#/#///#/#///
#/###/#/###/###/#/#/#######/###/
#///#/#///#/////#/#///#/////#/#/
#/#/#####/#####/#/###/#/#####/#/
#/#/#///#/#/#///#/#/#///#/////#/
###/#/#/#/#/#/###/#/#####/#/#/#/
#///#/#///#///#///////#///#/#/#/
#/###/###/#####/#######/###/#/#/
#/#///#///#/////#/////#/#///#/#/
#/###/#####/#####/###/#/#/#####/
#///#/////////#///#/#///#/////#/
###/#########/#/###/#########/#/
#///#///////#/#/#/////#///////#/
#/#/#/#####/#/#/#/###/#/#######/
#/#/#/#/#///#/#/#/#///#/#///#///
#/###/#/#/#####/#/#/###/#/#/#/##
#///////#/////////#///#///#/////
