#/#############################
#/////////#///#///////////////#
#########/#/#/###/###########/#
#///////#/#/#///#///#///////#/#
#/#####/#/#/###/###/#/#######/#
#/#///#/#/#///#/////#/////////#
#/#/###/#/###/#######/#########
#/#///#/#/////#///#///#///////#
#/###/#/#######/#/#/#########/#
#///#/#/#///#///#///#///////#/#
#/#/#/#/#/#/#/#######/#####/#/#
#/#/#/#/#/#/#/////#///#///#///#
#/#/#/#/#/#/#####/#/###/#/###/#
#/#/#///#/#/////#/#/#///#///#/#
#/#/#/###/#####/#/#/#/#######/#
#/#/#/////#///#/#///#/////#///#
###/#########/#/#########/#/###
#///#/////////#///#/////#/#/#/#
#/#####/#####/###/#/###/#/#/#/#
#/#///#///#/#///#///#/////#/#/#
#/#/#/###/#/###/#/#########/#/#
#/#/#/////#/////#/#///#/////#/#
#/#/#############/#/#/#/#####/#
#/#///////////#///#/#///#/////#
#/#/#########/#/###/#######/###
#/#///#/////#///#/#/#/////#///#
#/#####/###/#/###/#/#/###/###/#
#/#///#/#///#/////#///#/#/////#
#/#/#/#/#/#############/#####/#
#///#///#/////////////////////#
#############################/#
