#/##############################
#///#///////////#///////#///////
###/###/#######/#/#####/#/#####/
#/#///#/#/////#///#///#///#///#/
#/###/#/#/#/#######/#/#####/###/
#///#///#/#/////////#/////#///#/
#/###########/###########/###/#/
#/////////////#///#/////#///#/#/
###/###########/#/#/#/#####/#/#/
#///#/////////#/#///#/////////#/
#/###/#######/#/#########/#####/
#/#/////#///#/#///#/////#/#/////
#/#####/#/#/#/###/#/###/###/####
#///#///#/#///#///#///#/////#///
#/#/#/###/#####/#####/#######/##
#/#/#/#///////#/////#///#///#///
#/#/#/#/###########/###/#/#/###/
#/#/#/#///#///////#///#/#/#/////
###/#/#/###/#####/#/###/#/######
#///#/#/#///#///#///#///#///////
#/###/#/#/###/#######/#########/
#/#///#/#/#///////#///#///#/////
#/#/#####/#/#####/#/###/#/#/###/
#/#///#///#/#///#/#/////#/#/#/#/
#/###/#/#####/#/#/#######/#/#/#/
#/#///#///////#/#/////#/#///#/#/
#/#/###########/#/###/#/#####/#/
#/#/#/////////#///#/#/#///#/#///
#/#/#/#####/#######/#/#/#/#/#/##
#/#///#///#/////////////#///#/#/
#/#####/#/###################/#/
#///////#///////////////////////
