#/#############################
#/#///////#/////////////////#/#
#/#/#######/#####/#########/#/#
#/#/////#///#///#/#///////#///#
#/#####/#/###/###/###/#/#####/#
#/////#///////#///#///#/#/////#
#####/#######/#/###/###/#/#####
#///#///#/////#/#///#/#/#/////#
#/#####/#######/#/###/#/#####/#
#/////#///////#/#///#/#/////#/#
#/#/#/#######/#/#/#/#/#####/#/#
#/#/#/#/////#/#/#/#/#/////#/#/#
#/#/#/#/###/#/#/###/###/###/#/#
#/#/#/#///#///#///#/#///#///#/#
#/#/#####/#######/#/#/#/#/###/#
#/#///#///#/////#/#/#/#/#///#/#
#/###/#/###/###/#/#/#/#####/#/#
#/#///#/////#/#///#/#///////#/#
###/#/#######/#####/#########/#
#///#///#/////#/////#/////////#
#/#####/#/###/#/###/#/#########
#/#///#/#/#/////#///#/#///////#
#/#/#/#/#/#########/#/#/#####/#
#/#/#/#/#/#///#///#/#/#/#///#/#
#/#/###/#/#/#/#/#/#/#/#/#/#/#/#
#/#///////#/#///#/#/#///#/#/#/#
#/#######/#/#####/#/#####/###/#
#/#/////#/#/////#/#/////#/////#
#/#/###/#######/#/#######/#####
#/////#/////////#/////////////#
#############################/#
