#/#############################
#/////////#///////#///#///////#
#########/#####/#/#/#/###/###/#
#///////#/#/////#///#///#/#/#/#
#/#####/#/#/###########/#/#/#/#
#/#///#/#///#/////#///#///#/#/#
###/#/#/#######/#/#/#/#####/#/#
#///#///////////#///#///////#/#
#/#########################/#/#
#///#/////#///#///////#///#/#/#
###/#/###/###/#/#/#/###/#/#/#/#
#///#///#///#///#/#/#///#///#/#
#/###/#/###/#####/###/#######/#
#/#///#/#/#///#///#///#/////#/#
#/#/###/#/###/#/###/###/###/#/#
#/#/#///#/#///#/#///#/#///#///#
#/#/#/###/#/###/#/###/###/#####
#/#/#/#///#/////#/////#/#/////#
#/#/#/#/#######/#####/#/#####/#
#/#/#/#///////#/////#///////#/#
#/#/#/###/#########/#######/#/#
#/#/#///#///////////////#///#/#
#/#####/###############/#/###/#
#/#///#/////////////#///#/#///#
#/#/#/#/#####/#####/#####/#/###
#/#/#/#/#///#/#///#///////#///#
#/#/#/###/#/###/#/###/#######/#
#/#/#///#/#///#/#///#/#///////#
#/#/###/#/###/#/###/###/#######
#/////#/////#/////#///////////#
#############################/#
