#/##############################
#/////#/////////#///////#///////
#####/#/#######/#/#/###/#/#####/
#///#///#///#///#/#/#/#///#///#/
#/#/#####/###/#####/#/#####/#/#/
#/#///////#///#/////#///#///#/#/
#####/###/#/###/#####/#/#/###/#/
#///#/#///#/////#/////#///#/#/#/
#/#/#/#/#############/#####/#/#/
#/#///#/////#/////#///#/////#/#/
#/#########/#/###/#/###/#####/#/
#/#/////#///#/#///#/#/////////#/
#/#####/#/###/#/###/#######/###/
#/#///#///////#/#///#/////#/#///
#/#/#/#########/#/#/#/###/###/##
#/#/#/#///////#///#/#///#/#///#/
#/#/#/#/#####/#####/###/#/#/###/
#/#/#///#///#/#/#///#/#/#///#///
#/#/#####/###/#/#/###/#/#####/#/
#/#/////#/#///#/#/////#///#///#/
#/#####/#/#/###/#####/###/#/###/
#///#/#///#/#///////#///#///#/#/
#/#/#/###/#/#/#########/#####/#/
#/#///#///#/#/#/////////////#/#/
#/###/#/###/#/#/###########/#/#/
#/#/#/#/#///#/////#/////#///#/#/
#/#/#/#/#/#########/###/#/###/#/
#/#/#/#/#///////////#///#/#///#/
#/#/#/#/#############/###/#/#/#/
#/#///#///////////#///#/////#/#/
#/###############/#/###########/
#/////////////////#/////////////
