#/#############################
#/////////////////#///#///////#
#################/#/#/#/#####/#
#/////////#/////#///#///#///#/#
#/#/#####/#/###/#########/###/#
#/#/#///#/#///#/////////#/////#
###/#/#/#/###/#####/#####/#####
#///#/#/#///#/////#/#///#///#/#
#/###/#####/#####/###/#/###/#/#
#/#///////#/#/////#///#///#///#
#/#####/#/#/#/#/###/#####/###/#
#/#///#/#/#///#/#///#///#/#///#
#/#/#/#/###/#####/###/###/#/###
#///#/#///#/#/////////#///#/#/#
#/###/#/#/#/#/#########/###/#/#
#///#/#/#///#/////#/////#///#/#
#####/#/#####/#####/###/#/###/#
#/////#///#///#/////#///#/#///#
#/#####/###/###/###/#####/###/#
#///#///#///#/#///#/#///#///#/#
#/#/#####/###/###/###/#/###/#/#
#/#/////#///#///#/////#/#///#/#
#/#####/###/#/#/#######/#/###/#
#/#///#///#///#///#/////#/////#
#/#/#/###/#######/#/###/#####/#
#///#///#///////#/#/#/#/////#/#
#######/#####/###/#/#/#####/#/#
#/#///#/#///#///#/#/#///////#/#
#/#/#/#/#/#/###/#/#/#########/#
#///#/////#///#///#///////////#
#############################@#
