#/##############################
#/#/////#///////#/////////#/////
#/###/#/#/#####/#######/#/#/###/
#/////#///#///#///////#/#/#///#/
#############/#######/#/#/###/#/
#/////#/////#/////#///#/#/#///#/
#/###/###/#/#/###/#/###/#/#/###/
#/#///#///#///#/#/#/////#/#/#///
#/#/###/#######/#/#######/#/#/##
#/#///#/#///#/////#/#///#/#/#/#/
#/###/#/#/#/#/#####/#/#/#/#/#/#/
#/#/#/#/#/#/#///////#/#///#/#///
#/#/#/#/#/#########/#/#####/###/
#/#/#///#///////#///#///////#/#/
#/#/#######/###/#/###########/#/
#/#///////#/#///#/#/////#/////#/
#/#/#####/###/#/#/#/###/#/###/#/
#/#/////#/////#/#/#/#///#///#/#/
#/#####/#########/#/#/###/#/###/
#///#///#/////#///#/#/#///#///#/
###/#/###/###/#/###/#/###/###/#/
#///#///#///#///#///#///#/#///#/
#/#####/###/#####/#####/#/#/###/
#/////#///#/////#/#///#/#/#///#/
#/###/#/#/#####/#/#/###/#####/#/
#/#///#/#/////#///#///#/#/////#/
#/#/###/#############/#/#/#/###/
#/#///#///////////////#///#/#///
#/###/#/#######/#########/###/##
#/#///#///#///#///////////#///#/
#/#/#######/#/#############/###/
#/#/////////#///////////////////
