#/##############################
#/#///////////#/#///////////#///
#/#######/###/#/#/#/#######/###/
#///////#/#/#/#///#/////#/#/////
#######/#/#/#/###/#####/#/#####/
#/////#///#/#///#/#/////#///#///
#/#/#######/###/###/#######/#/##
#/#///////////#///#/#///////#/#/
#/#####/#####/###/#/#/#/###/#/#/
#/////#/////#///#///#/#/#/#/#///
###/#######/###/#######/#/#/###/
#///#///////#/#/#///////#///#/#/
#####/#######/#/#/###/#####/#/#/
#/////#///////#///#///#///#///#/
#/#####/###########/###/#/###/#/
#/#/////////////#/#/#/#/#/#///#/
#/#/#########/#/#/#/#/#/#/#####/
#/#/#///////#/#///#///#/#///////
#/###/#####/#/###/###/#/########
#/////#///#/#/#/#///#/#/#///////
#/#####/#/#/#/#/###/#/#/#/#####/
#/#/////#/#/#/#/////#/#///#///#/
#/#/#####/#/#/#####/#/#####/###/
#/#/#///#///#/#///#/#/#/////#///
###/#/#######/#/#/###/###/###/##
#///#/#/////////#/////////#///#/
#/###/#/#################/#/###/
#/#/////#///////////#/#///#///#/
#/#/#####/#########/#/#/#####/#/
#/#/#/////#///#/#///#///////#///
#/###/#####/#/#/#/#############/
#///////////#///#///////////////
