#/#############################
#///#/////#///#///////////////#
###/#/###/#/#/###/#/#########/#
#///#///#///#///#/#///#/////#/#
#/#####/#######/###/#/#/###/#/#
#///#///#/////#///#/#/#/#/#/#/#
###/#/#####/#####/###/#/#/#/#/#
#/#///#///#/////#/////#/#///#/#
#/#####/#/#/###/#######/#/###/#
#///////#/#/#///////////#/#/#/#
#####/###/###/###########/#/#/#
#/////#/#///#///#/#/////#///#/#
#/#####/###/#/#/#/#/#/#/###/#/#
#/#///#/////#/#/#///#/#///#/#/#
#/#/#/#/#######/#####/#####/#/#
#/#/#///////////#///#/#///#/#/#
#/###############/#/#/#/#/#/#/#
#/#///#///#/////#/#///#/#///#/#
#/#/#/#/#/#/###/#/#/###/#####/#
#/#/#///#/#/#///#/#/#///#///#/#
#/#/#####/#/#/###/###/###/#/#/#
#/#/#///#///#///#/////#///#/#/#
#/#/#/#########/#/#######/#/#/#
#///#/////////#/#///////#/#/#/#
#/#####/###/###/#/#####/#/#/#/#
#/#///#/#/#/#///#/#///#///#/#/#
#/#/#/#/#/#/#/###/#/#/#######/#
#///#///#/#/#///#/#/#///#///#/#
#########/#/###/###/###/#/#/#/#
#/////////////#///////#///#///#
#############################@#
